mystery - тайна
dream - мечта
strength - сила
miracle - чудо
magic - магия
happiness - счастье
luck - удача
victory - победа
joy - радость
peace - мир
calm - спокойствие
hope - надежда
sadness - грусть
fear - страх
fate - судьба
freedom - свобода
harmony - гармония
truth - правда
memory - память
loneliness - одиночество
adventure - приключение
gratitude - благодарность
loyalty - верность
courage - мужество
warmth - тепло
cold - холод
life - жизнь
death - смерть
birth - рождение
overcoming - преодоление
riddle - загадка
emptiness - пустота
eternity - вечность
moment - момент
darkness - тьма
temptation - искушение
infinity - бесконечность
harvest - урожай
love - любовь
anger - гнев
surprise - удивление
excitement - волнение
pride - гордость
shame - стыд
guilt - вина
envy - зависть
jealousy - ревность
delight - восторг
satisfaction - удовлетворение
disappointment - разочарование
anxiety - тревога
panic - паника
confusion - замешательство
curiosity - любопытство
passion - страсть
desire - желание
frustration - раздражение
boredom - скука
nostalgia - ностальгия
tenderness - нежность
compassion - сострадание
pity - жалость
admiration - восхищение
respect - уважение
disgust - отвращение
horror - ужас
awe - трепет
euphoria - эйфория
serenity - безмятежность
melancholy - меланхолия
despair - отчаяние
optimism - оптимизм
pessimism - пессимизм
inspiration - вдохновение
determination - решимость
hesitation - колебание
regret - сожаление
relief - облегчение
vulnerability - уязвимость
confidence - уверенность
insecurity - неуверенность
empathy - эмпатия
indifference - безразличие
anticipation - предвкушение
thrill - трепет
contentment - довольство
bliss - блаженство
agitation - возбуждение
gratitude - благодарность