
sun - солнце
moon - луна
star - звезда
wind - ветер
fire - огонь
water - вода
earth - земля
sky - небо
rainbow - радуга
light - свет
rain - дождь
snow - снег
river - река
forest - лес
field - поле
fog - туман
sunset - закат
dawn - рассвет
thunder - гром
lightning - молния
mountain - гора
ocean - океан
volcano - вулкан
blizzard - метель
frost - иней
hail - град
dew - роса
avalanche - лавина
nebula - туманность
tsunami - цунами
breeze - бриз
glacier - ледник
hurricane - ураган
comet - комета
galaxy - галактика
constellation - созвездие
cloud - облако
cave - пещера
aurora - северное сияние
lotus - лотос
crystal - кристалл
downpour - ливень
