spark - искра
song - песня
voice - голос
whisper - шёпот
scream - крик
melody - мелодия
rhythm - ритм
creativity - творчество
echo - эхо
firefly - светлячок
plant - растение
crane - журавль
phoenix - феникс
cicada - цикада
ash tree - ясень
heather - вереск
orchid - орхидея
cedar - кедр
jasmine - жасмин
pearl - жемчуг
coral - коралл
sapphire - сапфир
emerald - изумруд
silver - серебро
amber - янтарь
mandala - мандала
bell - колокол
labyrinth - лабиринт
bonfire - костёр
flame - пламя
sparkle - блеск
flicker - мерцание
splash - всплеск
reflection - отражение
fragrance - аромат
trembling - дрожь
whirlpool - водоворот
soaring - парение
chamber - покой
rustle - шелест
cluster - скопление
call - зов
source - источник
key - ключ